35 36 36 36 36 36 22 30 30 30 30 30 30 30 30 30 30 30 30 30 30 30 30 30 30 35 36 36 36 36 36 22
23 36 36 36 36 36 24 31 31 31 31 31 31 31 31 31 31 31 31 31 31 31 31 31 31 23 36 36 36 36 36 24
23 36 27 26 26 26 25 31 31 31 31 31 31 31 31 31 31 31 31 31 31 31 31 31 31 28 26 26 26 29 36 24
23 36 24 31 31 31 31 31 31 31 31 31 31 31 31 31 31 31 31 31 31 31 31 31 31 31 31 31 31 23 36 24
23 36 24 31 31 31 31 31 31 31 31 31 31 31 31 31 31 31 31 31 31 31 31 31 31 31 31 31 31 23 36 24
23 36 24 31 31 31 31 31 31 31 31 31 31 31 31 31 31 31 31 31 31 31 31 31 31 31 31 31 31 23 36 24
28 26 25 31 31 31 31 31 31 31 31 31 31 31 31 31 31 31 31 31 31 31 31 31 31 31 31 31 31 28 26 25
34 31 31 31 31 31 31 31 31 31 31 31 31 31 31 31 31 31 31 31 31 31 31 31 31 31 31 31 31 31 31 32
34 31 31 31 31 31 31 31 31 31 31 31 31 31 31 31 31 31 31 31 31 31 31 31 31 31 31 31 31 31 31 32
34 31 31 31 31 31 31 31 31 31 31 31 31 31 31 31 31 31 31 31 31 31 31 31 31 31 31 31 31 31 31 32
34 31 31 31 31 31 31 31 31 31 35 36 36 36 36 36 36 36 36 36 36 22 31 31 31 31 31 31 31 31 31 32
34 31 31 31 31 31 31 31 31 31 23 36 36 36 36 36 36 36 36 36 36 24 31 31 31 31 31 31 31 31 31 32
34 31 31 31 31 31 31 31 31 31 23 36 36 36 36 36 36 36 36 36 36 24 31 31 31 31 31 31 31 31 31 32
34 31 31 31 31 31 31 31 31 31 23 36 36 36 36 36 36 36 36 36 36 24 31 31 31 31 31 31 31 31 31 32
34 31 31 31 31 31 31 31 31 31 23 36 36 36 36 36 36 36 36 36 36 24 31 31 31 31 31 31 31 31 31 32
34 31 31 31 31 31 31 31 31 31 23 36 36 36 36 36 36 36 36 36 36 24 31 31 31 31 31 31 31 31 31 32
34 31 31 31 31 31 31 31 31 31 23 36 36 36 36 36 36 36 36 36 36 24 31 31 31 31 31 31 31 31 31 32
34 31 31 31 31 31 31 31 31 31 23 36 36 36 36 36 36 36 36 36 36 24 31 31 31 31 31 31 31 31 31 32
34 31 31 31 31 31 31 31 31 31 23 36 36 36 36 36 36 36 36 36 36 24 31 31 31 31 31 31 31 31 31 32
34 31 31 31 31 31 31 31 31 31 23 36 36 36 36 36 36 36 36 36 36 24 31 31 31 31 31 31 31 31 31 32
34 31 31 31 31 31 31 31 31 31 23 36 36 36 36 36 36 36 36 36 36 24 31 31 31 31 31 31 31 31 31 32
34 31 31 31 31 31 31 31 31 31 28 26 26 26 26 26 26 26 26 26 26 25 31 31 31 31 31 31 31 31 31 32
34 31 31 31 31 31 31 31 31 31 31 31 31 31 31 31 31 31 31 31 31 31 31 31 31 31 31 31 31 31 31 32
34 31 31 31 31 31 31 31 31 31 31 31 31 31 31 31 31 31 31 31 31 31 31 31 31 31 31 31 31 31 31 32
34 31 31 31 31 31 31 31 31 31 31 31 31 31 31 31 31 31 31 31 31 31 31 31 31 31 31 31 31 31 31 32
35 36 22 31 31 31 31 31 31 31 31 31 31 31 31 31 31 31 31 31 31 31 31 31 31 31 31 31 31 35 36 22
23 36 24 31 31 31 31 31 31 31 31 31 31 31 31 31 31 31 31 31 31 31 31 31 31 31 31 31 31 23 36 24
23 36 24 31 31 31 31 31 31 31 31 31 31 31 31 31 31 31 31 31 31 31 31 31 31 31 31 31 31 23 36 24
23 36 24 31 31 31 31 31 31 31 31 31 31 31 31 31 31 31 31 31 31 31 31 31 31 31 31 31 31 23 36 24
23 36 36 36 36 36 22 31 31 31 31 31 31 31 31 31 31 31 31 31 31 31 31 31 31 35 36 36 36 36 36 24
23 36 36 36 36 36 24 31 31 31 31 31 31 31 31 31 31 31 31 31 31 31 31 31 31 23 36 36 36 36 36 24
28 26 26 26 26 26 25 33 33 33 33 33 33 33 33 33 33 33 33 33 33 33 33 33 33 28 26 26 26 26 26 25