41 41 41 42 42 42 42 42 42 42 42 42 42 42 42 42 42 42 42 42 42 42 42 42 42 42 42 42 42 41 41 41
41 41 41 38 38 38 38 38 38 38 38 38 38 38 38 38 38 38 38 38 38 38 38 38 38 38 38 38 38 41 41 41
41 41 41 38 38 38 38 38 38 38 38 38 38 38 38 38 38 38 38 38 38 38 38 38 38 38 38 38 38 41 41 41
37 38 38 38 38 38 38 38 38 38 38 38 38 38 38 38 38 38 38 38 38 38 38 38 38 38 38 38 38 38 38 39
37 38 38 38 38 38 38 38 38 38 38 38 38 38 38 38 38 38 38 38 38 38 38 38 38 38 38 38 38 38 38 39
37 38 38 38 38 38 38 38 41 41 41 41 41 41 41 41 41 41 41 41 41 41 41 41 38 38 38 38 38 38 38 39
37 38 38 38 38 38 38 38 41 41 41 41 41 41 41 41 41 41 41 41 41 41 41 41 38 38 38 38 38 38 38 39
37 38 38 38 38 38 38 38 38 38 38 38 38 38 38 38 38 38 38 38 38 38 38 38 38 38 38 38 38 38 38 39
37 38 38 38 38 38 38 38 38 38 38 38 38 38 38 38 38 38 38 38 38 38 38 38 38 38 38 38 38 38 38 39
37 38 38 38 38 41 41 38 38 38 38 38 38 38 38 38 38 38 38 38 38 38 38 38 38 41 41 38 38 38 38 39
37 38 38 38 38 41 41 38 38 38 41 41 38 38 38 38 38 38 38 38 41 41 38 38 38 41 41 38 38 38 38 39
37 38 38 38 38 41 41 38 38 38 41 41 38 38 38 38 38 38 38 38 41 41 38 38 38 41 41 38 38 38 38 39
37 38 38 38 38 41 41 38 38 38 38 38 41 41 38 38 38 38 41 41 38 38 38 38 38 41 41 38 38 38 38 39
37 38 38 38 38 41 41 38 38 38 38 38 41 41 38 38 38 38 41 41 38 38 38 38 38 41 41 38 38 38 38 39
37 38 38 38 38 41 41 38 38 38 38 38 38 38 41 41 41 41 38 38 38 38 38 38 38 41 41 38 38 38 38 39
37 38 38 38 38 41 41 38 38 38 38 38 38 38 41 41 41 41 38 38 38 38 38 38 38 41 41 38 38 38 38 39
37 38 38 38 38 41 41 38 38 38 38 38 38 38 41 41 41 41 38 38 38 38 38 38 38 41 41 38 38 38 38 39
37 38 38 38 38 41 41 38 38 38 38 38 38 38 41 41 41 41 38 38 38 38 38 38 38 41 41 38 38 38 38 39
37 38 38 38 38 41 41 38 38 38 38 38 41 41 38 38 38 38 41 41 38 38 38 38 38 41 41 38 38 38 38 39
37 38 38 38 38 41 41 38 38 38 38 38 41 41 38 38 38 38 41 41 38 38 38 38 38 41 41 38 38 38 38 39
37 38 38 38 38 41 41 38 38 38 41 41 38 38 38 38 38 38 38 38 41 41 38 38 38 41 41 38 38 38 38 39
37 38 38 38 38 41 41 38 38 38 41 41 38 38 38 38 38 38 38 38 41 41 38 38 38 41 41 38 38 38 38 39
37 38 38 38 38 41 41 38 38 38 38 38 38 38 38 38 38 38 38 38 38 38 38 38 38 41 41 38 38 38 38 39
37 38 38 38 38 38 38 38 38 38 38 38 38 38 38 38 38 38 38 38 38 38 38 38 38 38 38 38 38 38 38 39
37 38 38 38 38 38 38 38 38 38 38 38 38 38 38 38 38 38 38 38 38 38 38 38 38 38 38 38 38 38 38 39
37 38 38 38 38 38 38 38 41 41 41 41 41 41 41 41 41 41 41 41 41 41 41 41 38 38 38 38 38 38 38 39
37 38 38 38 38 38 38 38 41 41 41 41 41 41 41 41 41 41 41 41 41 41 41 41 38 38 38 38 38 38 38 39
37 38 38 38 38 38 38 38 38 38 38 38 38 38 38 38 38 38 38 38 38 38 38 38 38 38 38 38 38 38 38 39
37 38 38 38 38 38 38 38 38 38 38 38 38 38 38 38 38 38 38 38 38 38 38 38 38 38 38 38 38 38 38 39
41 41 41 38 38 38 38 38 38 38 38 38 38 38 38 38 38 38 38 38 38 38 38 38 38 38 38 38 38 41 41 41
41 41 41 38 38 38 38 38 38 38 38 38 38 38 38 38 38 38 38 38 38 38 38 38 38 38 38 38 38 41 41 41
41 41 41 40 40 40 40 40 40 40 40 40 40 40 40 40 40 40 40 40 40 40 40 40 40 40 40 40 40 41 41 41